Art	 Allard
Augustina	 Goetz
Digna	 Dillard
Elenor	 Windham
Newton	 Corral
Christen	 Mejia
Bunny	 Cable
Crissy	 Dick
Kimi	 Ellsworth
Rachell	 Paterson
Billi	 Trinidad
Yuri	 Kinsey
Kris	 Burden
Jospeh	 Rollins
Fiona	 Mcrae
Riley	 Gough
Russel	 Tennant
Bruno	 Crowe
Hana	 Cope
Sherill	 Hoang
Zora	 Fite
Merrie	 Barone
Lavonna	 Christy
Danica	 Woodruff
Retta	 Lavigne
Dominique	 Gagnon
Corrinne	 Duke
Tamera	 Rossi
Dannette	 Forrest
Layne	 Foret
Monte	 Gunn
Danae	 Montano
Shaquita	 Moffett
Adrianna	 Waddell
Gena	 Maier
Twanna	 Wilmoth
Verona	 Mize
Shanita	 Bellamy
Britney	 Way
Hobert	 Rush
Jovan	 Alcorn
Myriam	 Sorenson
Billie	 Headrick
Althea	 Renteria
Jennefer	 Beeler
Cari	 Salisbury
Azucena	 Madden
Rachele	 Taggart
Hayden	 Penn
Lauralee	 Logue
Marianna	 Lacy
Kassandra	 Odom
Emmie	 Mora
Ahmad	 Bowser
Jutta	 Forrester
Andria	 Mccorkle
Odilia	 Valentin
Darcie	 Elston
Adalberto	 Weed
Jonell	 Ellington
Milan	 Lacey
Shon	 Redmond
Jaclyn	 Durham
Katharyn	 Denney
Elissa	 Ponder
Annabelle	 Akers
Sid	 Helton
Min	 Greco
Dick	 Mcmanus
Sharilyn	 Kong
Toccara	 Reagan
Devin	 Nye
Luigi	 Hutcherson
Deja	 Milburn
Leontine	 Withrow
Trisha	 Mast
Abbey	 Nettles
Jackqueline	 Hook
Margarette	 Galbraith
Rhona	 Brito
Maple	 Mccrary
Clarinda	 Dotson
Emogene	 Barron
Pauletta	 Leal
Susann	 Lenz
Hermine	 Homan
Nestor	 Mcgraw
Harley	 Sawyer
Linh	 Loper
Dirk	 Rosenthal
Donnie	 Hollins
Fransisca	 Muniz
Eleonore	 Velez
Shaquana	 Neely
Rima	 Leak
Marylou	 Cutler
Carlos	 Scarbrough
Nelia	 Libby
Tena	 Levesque
Pa	 Prentice